                                                                                                                                                                                                                                                                              
                                                                                                                                                                                                                                                                              
                                                                                                                                      %%%%%%%%%%%%%%%%%%%%%%%%%%%%%%%%%%%%%%                                                                                                  
                                                                                                                                    %%%%                                  %%%%                                                                                                
                                                                                                                                  %%%%                                      %%%%                                                                                              
                                                                                                                                %%%%                 cafeteria                %%%%                                                                                            
                                                                                                                              %%%%?                                            Y%%%%                  %%%%%%%%%%%%%%%%                                                        
                                                                                                                            %%%%                                                  %%%%                %%    |Y      %%%%                                                      
                                                                                                                          %%%%      ______                              ______     T%%%%              %%    |    ##   %%%%                                                    
                                                                                                                        %%%%       /      \                            /      \       %%%%            %%    |           %%%%                                                  
                                  %%%%%%%%%%%%%%%%%%%%%%%%%%%%%%                                                        %%        / "      \                          / -      \        %%            %%    |             %%%%                                                
                                %%%%     }{                   %%                                                        %%        |        |                          |        |        %%            %%    |               %%%%                                              
                              %%%%                        ##  %%                                                        %%        \      L /                          \      ' /        %%            %%   /                  %%%%                                            
                            %%%%                              %%                                                        %%         \______/                            \______/         %%            %%  |                     %%%%                                          
                            %%------------------              %%                                                        %%                                                              %%            %%  |     __[+]             %%                                          
                            %%==\ `III`     |\ |              %%%%%%%%%%%%%%%%%%%%%%%%%%%%%%%%%%%%%%%%%%%%%%%%~%%%%%%%%%%%                            ______                            %%%%%%%%%%%%%%%%--/    ((L" ))            %%                                          
                            %%===K III   <=>|-\|                                                                                                     /      \                                                  /=====\          }{%%                                          
                            %%==/  III      |-||                                                                                                    /  ,,,,  \                                                               -----%%                                          
                            %%    `III`  <=>|-||     engine                                                                                         |  [()]  |                                                              /     %%                                          
                            %%]]]=======O   |-/|                                                                                                    \  ''''  /                                                             /      %%                                          
                            %%____          |/ |                                                                                                     \______/                                                             /       %%                                          
                            %%====|-------------              %%%%%%%%%%%%%%%%%%%%%%%%%%%%%%%%%%          %%%%%%%%%%%%%%%%                                                              %%%%%%%%%%%%%%%%%%-----|          |       %%                                          
                            %%-[]-|<()                        %%                              %%          %%            %%          ______                              ______          %%              %%%%   |          |       %%                                          
                            %%                                %%                    %%%%%%%%%%%%          %%%%%%%%%%%%  %%         /    - \                            /      \         %%                %%%% |          |       %%                                          
          %%%%%%%%%%%%%%    %%                                %%                    %%      +                +      %%  %%        /        \                          / '-     \  ##    %%                  %%%%          |       %%                                          
        %%%%  [w]     %%    %%                                %%                    %%                              %%  %%        |      ' |                          |        |        %%                    %%          %%%%%%%%%%                                          
      %%%%            %%    %%%%%%%%%%%%%%          %%%%%%%%%%%%                    %%booo                      oood%%  %%        \      - /                          \        /        %%                    %%          %%                                                  
    %%%%              %%                %%          %%                              %%                              %%  %%%%       \______/                            \______/       %%%%      %%%%%%%%%%%%  %%          %%                                                  
  %%%%                %%                %%          %%             %%%%%%%%         %%                              %%    %%%%                                                      %%%%      %%%%|====|==%%  %%          %%                                                  
  %% |                %%%%%%%%%%        %%          %%          %%%%==[]==%%%%      %%booo                      oood%%%%    %%%%                                                  %%%%      %%%%  |(::)|  %%%%%%          %%%%%%%%%%%%%%%%%%          %%%%%%%%%%%%%           
  %%*|                   }{   %%        %%          %%        %%%%   L      %%%%    %%                                %%%%    %%%%                                              %%%%      %%%%#             }{                            %%          %%      }{ %%%%         
  %% |    ##                  %%        %%          %%        %%           }{ %%    %%                                  %%%%    %%%%                                          %%%%      %%%%                                              %%          %%  ##       %%%%       
  %%*|                        %%        %%          %%        %%              %%    %%             medbay                 %%%%    %%%%                                      %%%%      %%%%T                                               %%          %%             %%%%     
  %% |                        %%        %%          %%        %%              %%    %%                                   [+]%%%%    %%%%                                  %%%%      %%%%             O2                                   %%          %%            L  %%%%   
  %%*|                        %%        %%          %%        %%              %%    %%  ##                                    %%%%    %%%%%%%%%%%%%%          %%%%%%%%%%%%%%        %%  ___     ___     ___                               %%~%%%%%%%%%%%                  %%  
  %% |                        %%%%%%%%~%%%          %%%%%%%%%%%%              %%    %%                                          %%                %%          %%                    %%_/(=)\___/(=)\___/(=)\%%%%%%%%%%%%%%%%%%%%                   ?                    /\%%  
  %%_M_                                                                       %%    %%%%                                 ____   %%                %%          %%                    %%][=o=][v][=o=][v][=o=]%%                %%                                        | %%  
  %% * \_                                                                     %%      %%%%                              ((__))  %%                %%          %%                    %%%%%%%%%%%%%%%%%%%%%%%%%%                %%                          navigation   L| %%  
  %%* *|*\                       reactor            security                  %%        %%%%                                    %%                %%          %%                                                              %%                                        | %%  
  %% * \\::                                                               ____%%          %%%%%%%%%%%%%%%%%%%%%%%%%%%%%%%%%%%%%%%%                %%          %%%~%%%%%%%%%%%%%%%%%%%%%%%%%%%%%%%%%%%%%%%%    %%%%%%%%%%%%%%%%%%                                        \/%%  
  %%___||                                                                 |  |%%                                                                  %%                    ?       Y     [=][=][=]       ::%%    %%  ##                      %%%%%%%%%%%%%%                  %%  
  %% |                        %%%%%%%%%%%%          %%%%%%%%%%%%          \  |%%                                                                  %%                                   n  L  n          %%    %%                          %%          %%            L   %%%%  
  %%*|                        %%        %%          %%        %%         L |_|%%                                                                  %%                                                    %%    %%                          %%          %%              %%%%    
  %% |                        %%        %%          %%        %%              %%            %%%%%%%%%%%%%%%%%%%%%%%%%%%%%%%%%%%%%%                %%                                                    %%    %%                          %%          %%  ##        %%%%      
  %%*|              ##        %%        %%          %%        %%              %%            %% Y     }{     ?         |[+][!][=]%%                %%                                ____________        %%    %%                          %%          %%       Y  %%%%        
  %% |                        %%        %%          %%        %%          ##  %%            %%                        ----------%%                %%          %%%%%%%%%%%%%%%%     |   o-=O-q   |       %%    %%          %%%%%%%%%%%%%%%%%%          %%%%%%%%%%%%%%          
  %%*|                        %%        %%          %%        %%              %%            %%                                  %%                %%          %%            %%     [] 0+ob\o+D []       %%    %%          %%                                                  
  %% |                %%%%%%%%%%        %%          %%        %%%%%%%%%%%%%%%%%%            %%  ##                              %%                %%          %%            %%     []  o-=0-d  []       %%    %%          %%                                                  
  %%%%                %%                %%          %%                                      %%                                %%%%                %%          %%            %%     |____________|       %%    %%          %%                                                  
    %%%%              %%                %%          %%                                      %%                              %%%%        %%%%%%%%%%%%          %%%%%%%%      %%          \__/            %%    %%          %%                                                  
      %%%%            %%    %%%%%%%%%%%%%%          %%%%%%%%%%%%                            %%                            %%%%        %%%%      ?                   %%      %%                          %%    %%          %%                                                  
        %%%%  [w]     %%    %%     }{                         %%                            %%                          %%%%        %%%%                            %%      %%                        %%%%    %%          %%                                                  
          %%%%%%%%%%%%%%    %%                                %%                            %%-----------------         %%        %%%%++|                           %%      %%                      %%%%      %%          %%                                                  
                            %%                                %%                            %%|[?][!][=][+][-]|         %%      %%%%I=I+/                           %%      %%  ##      admin     %%%%        %%          %%                                                  
                            %%-----------------               %%                            %%-----------------         %%      %%I=I_I                             %%      %%                  %%%%          %%          %%                                                  
                            %%==\ `III`     |\ |              %%%%%%%%%%%%%%%%%%%%%%%%      %%                          %%      %%I_I           ___________         %%      %%%%%%%%%%%%%%%%%%%%%%            %%          %%                                                  
                            %%===K III   <=>|-\|                                    %%      %%                          %%      %%             /          /|        %%                                        %%          %%                                                  
                            %%==/  III      |-||                                    %%      %%                          %%      %%            /          / |        %%                                      %%%%          %%%%%%%%%%%%                                        
                            %%    `III`  <=>|-||     engine                         %%      %%                        %%%%      %%           /          /  |        %%                                    %%%%  |                 }{%%                                        
                            %%]]]========O  |-/|                                    %%      %%    electrical        %%%%        %%          /__________/   |        %%                                  %%%%   /            ________%%                                        
                            %%____          |/ |                                    %%      %%                    %%%%          %%          |          |   |        %%%%%%%%%%%%%%%%%%%%%%%%%%%%%%%%%%%%%%----/             \       %%                                        
                            %%====|-------------              %%%%%%%%%%%%          %%      %%                  %%%%            %%        __|==========|   |                                                                 \      %%                                        
                            %%-[]-|<()                        %%        %%          %%      %%                %%%%              %%       /__|          |  /_                                                                  \     %%                                        
                            %%%%                              %%        %%          %%      %%          %%%%%%%%                %%       |  |          | /I=I                                                                 |     %%                                        
                              %%%%                        ##  %%        %%          %%      %%          %%                      %%       |__|   _____  |/ I_I                                                      shields    |     %%                                        
                                %%%%                          %%        %%          %%      %%          %%                      %%         @|__/___ /|_|                                                                      |     %%                                        
                                  %%%%%%%%%%%%%%%%%%%%%%%%%%%%%%        %%          %%%%%%%%%%          %%%%%%%%%%%%%%%%%%%%%%%%%%             |    |/              %%%%%%%%%%%%%%%%%%          %%%%%%%%%%-----               /     %%                                        
                                                                        %%                                                                     |____|               %%              %%          %%      %%     \             /      %%                                        
                                                                        %%                                                                                          %%              %%          %%      %%      \           /     %%%%                                        
                                                                        %%                                                                                          %%  %%%%%%%%%%%%%%          %%%%%%  %%       \         /    %%%%                                          
                                                                        %%                                                                                          %%  %%][][][]Y               }{ %%  %%        \       /   %%%%                                            
                                                                        %%                                                                                          %%  %%                          %%  %%        |       | %%%%                                              
                                                                        %%%%%%%%%%%%%%%%%%%%%%%%%%%%%%%%%%%%%%%%%%%%%%%%%%%%%%%%%%                                  %%  %%                          %%  %%--------|       %%%%                                                 
                                                                                                                                %%%%             storage            %%  %%                          %%  %%-()       ##  %%%%                                                  
                                                                                                                                  %%%%                              %%  %%                          %%  %%            %%%%                                                    
                                                                                                                                    %%%%                            %%  %%]     communications     [%%  %%%%%%%%%%%%%%%%                                                      
                                                                                                                                      %%%%                         T%%  %%]                        [%%                                                                        
                                                                                                                                        %%%%                    ****%%  %%]                        [%%                                                                        
                                                                                                                                          %%%%                  *\/*%%  %%%%                      %%%%                                                                        
                                                                                                                                            %%%%                */\*%%    %%%%                  %%%%                                                                          
                                                                                                                                              %%%%              ****%%      %%%%   [========] %%%%                                                                            
                                                                                                                                                %%%%%%%%%%%%%%%%%%%%%%        %%%%%%%%%%%%%%%%%%                                                                              
                                                                                                                                                                                                                                                                              
                                                                                                                                                                                                                                                                              
