                                                                                                                                    ▄████████████████████████████████████▄                                                                                                  
                                                                                                                                  ▄███▀                                ▀███▄                                                                                                
                                                                                                                                ▄███▀                                    ▀███▄                                                                                              
                                                                                                                              ▄███▀                                        ▀███▄                                                                                            
                                                                                                                            ▄███▀                                            ▀███▄                  ███████████████▄                                                        
                                                                                                                          ▄███▀                                                ▀███▄                ██           ▀███▄                                                      
                                                                                                                        ▄███▀                                                    ▀███▄              ██  ##         ▀███▄                                                    
                                                                                                                      ▄███▀                                                        ▀███▄            ██               ▀███▄                                                  
                                ▄█████████████████████████████                                                        ██▀                                                            ▀██            ██                 ▀███▄                                                
                              ▄███▀                         ██                                                        ██                                                              ██            ██                   ▀███▄                                              
                            ▄███▀                       ##  ██                                                        ██                                                              ██            ██                     ▀███▄                                            
                          ▄███▀                             ██                                                        ██                                                              ██            ██                       ▀███▄                                          
                          ██▀                               ██                                                        ██                                                              ██            ██                         ▀██                                          
                          ██                                ████████████████████████████████████████████████████████████                                                              ████████████████                          ██                                          
                          ██                                                                                                                                                                                                    ██                                          
                          ██                                                                                                                                                                                                    ██                                          
                          ██                                                                                                                                                                                                    ██                                          
                          ██                                                                                                                                                                                                    ██                                          
                          ██                                                                                                                                                                                                    ██                                          
                          ██                                ██████████████████████████████████          ████████████████                                                              ████████████████▄                         ██                                          
                          ██                                ██                              ██          ██            ██                                                              ██            ▀███▄                       ██                                          
                          ██                                ██                    ████████████          ████████████  ██                                                              ██              ▀███▄                     ██                                          
        ▄█████████████    ██                                ██                    ██                              ██  ██                                                        ##    ██                ▀███▄                   ██                                          
      ▄███▀         ██    ██                                ██                    ██                              ██  ██                                                              ██                  ▀███          ██████████                                          
    ▄███▀           ██    ██████████████          ████████████                    ██                              ██  ██▄                                                            ▄██                    ██          ██                                                  
  ▄███▀             ██                ██          ██                              ██                              ██  ▀███▄                                                        ▄███▀      ▄███████████  ██          ██                                                  
▄███▀               ██                ██          ██            ▄████████▄        ██                              ██▄   ▀███▄                                                    ▄███▀      ▄██▀        ██  ██          ██                                                  
██▀                 ██████████        ██          ██          ▄███==[]==███▄      ██                              ▀███▄   ▀███▄                                                ▄███▀      ▄██▀          ██████          ██████████████████          █████████████▄          
██                          ██        ██          ██        ▄███▀        ▀███▄    ██                                ▀███▄   ▀███▄                                            ▄███▀      ▄██▀                                            ██          ██         ▀███▄        
██      ##                  ██        ██          ██        ██▀            ▀██    ██                                  ▀███▄   ▀███▄                                        ▄███▀      ▄██▀                                              ██          ██  ##       ▀███▄      
██                          ██        ██          ██        ██              ██    ██                                    ▀███▄   ▀███▄                                    ▄███▀      ▄██▀                                                ██          ██             ▀███▄    
██                          ██        ██          ██        ██              ██    ██                                      ▀███▄   ▀███▄                                ▄███▀      ▄██▀                                                  ██          ██               ▀███▄  
██                          ██        ██          ██        ██              ██    ██  ##                                    ▀███    ▀█████████████          █████████████▀        ██                                                    ██████████████                 ▀██  
██                          ████████████          ████████████              ██    ██▄                                         ██                ██          ██                    ██                      ████████████████████                                          ██  
██                                                                          ██    ▀███▄                                ____   ██                ██          ██                    ██                      ██                ██                                          ██  
██                                                                          ██      ▀███▄                             ((__))  ██                ██          ██                    ██████████████████████████                ██                                          ██  
██                             reactor            security                  ██        ▀███▄                                   ██                ██          ██                                                              ██                                          ██  
██                                                                          ██          ▀███████████████████████████████████████                ██          ████████████████████████████████████████████    ██████████████████                                          ██  
██                                                                          ██                                                                  ██                                                    ██    ██                          ██████████████                 ▄██  
██                          ████████████          ████████████              ██                                                                  ██                                                    ██    ██                          ██          ██               ▄███▀  
██                          ██        ██          ██        ██              ██                                                                  ██                                                    ██    ██                          ██          ██             ▄███▀    
██                          ██        ██          ██        ██              ██            ██████████████████████████████████████                ██                                                    ██    ██                          ██          ██  ##       ▄███▀      
██                ##        ██        ██          ██        ██              ██            ██                                  ██                ██                                                    ██    ██                          ██          ██         ▄███▀        
██                          ██        ██          ██        ██          ##  ██            ██  ##                              ██                ██          ████████████████                          ██    ██          ██████████████████          █████████████▀          
██                          ██        ██          ██        ██              ██            ██                                  ██                ██          ██            ██                          ██    ██          ██                                                  
██▄                 ██████████        ██          ██        ██████████████████            ██                                 ▄██                ██          ██            ██                          ██    ██          ██                                                  
▀███▄               ██                ██          ██                                      ██                               ▄███▀                ██          ██            ██                          ██    ██          ██                                                  
  ▀███▄             ██                ██          ██                                      ██                             ▄███▀        ▄███████████          ████████      ██                          ██    ██          ██                                                  
    ▀███▄           ██    ██████████████          ██████████████                          ██                           ▄███▀        ▄███▀                         ██      ██                         ▄██    ██          ██                                                  
      ▀███▄         ██    ██                                  ██                          ██                          ███▀        ▄███▀                           ██      ██                       ▄████    ██          ██                                                  
        ▀█████████████    ██                                  ██                          ██████████████████          ██        ▄███▀                             ██      ██                     ▄████▀     ██          ██                                                  
                          ██                                  ██                          ██████████████████          ██      ▄███▀                               ██      ██  ##               ▄████▀       ██          ██                                                  
                          ██                                  ██                          ██████████████████          ██      ██▀                                 ██      ██                 ▄████▀         ██          ██                                                  
                          ██                                  ████████████████████████    ██                          ██      ██                                  ██      ██████████████████████▀           ██          ██                                                  
                          ██                                                        ██    ██                          ██      ██                                  ██                                       ▄██          ██                                                  
                          ██                                                        ██    ██                         ▄██      ██                                  ██                                     ▄████          ████████████                                        
                          ██                                                        ██    ██                       ▄███▀      ██                                  ██                                   ▄████▀                     ██                                        
                          ██                                                        ██    ██                     ▄███▀        ██                                  ██                                 ▄████▀                       ██                                        
                          ██                                                        ██    ██                   ▄███▀          ██                                  ██████████████████████████████████████▀                         ██                                        
                          ██                                  ████████████          ██    ██                 ▄███▀            ██                                                                                                  ██                                        
                          ██▄                                 ██        ██          ██    ██               ▄███▀              ██                                                                                                  ██                                        
                          ▀███▄                               ██        ██          ██    ██          ███████▀                ██                                                                                                  ██                                        
                            ▀███▄                             ██        ██          ██    ██          ██                      ██                                                                                                  ██                                        
                              ▀███▄                           ██        ██          ██    ██          ██                      ██                                                                                                  ██                                        
                                ▀███████████████████████████████        ██          ████████          ██████████████████████████                                  ██████████████████          ██████████                          ██                                        
                                                                        ██                                                                                        ██              ██          ██      ██                         ▄██                                        
                                                                        ██                                                                                        ██              ██          ██      ██                       ▄██▀                                         
                                                                        ██                                                                                        ██  ██████████████          ██████  ██                     ▄██▀                                           
                                                                        ██                                                                                        ██  ██                          ██  ██                   ▄██▀                                             
                                                                        ██                                                                                        ██  ██                          ██  ██                 ▄██▀                                               
                                                                        ████████████████████████████████████████████████████████▄                                 ██  ██                          ██  ██          ##   ▄██▀                                                 
                                                                                                                              ▀███▄                               ██  ██                          ██  ██             ▄██▀                                                   
                                                                                                                                ▀███▄                             ██  ██                          ██  ██           ▄██▀                                                     
                                                                                                                                  ▀███▄                           ██  ██                          ██  ██████████████▀                                                       
                                                                                                                                    ▀███▄                         ██  ██                          ██                                                                        
                                                                                                                                      ▀███▄                       ██  ██                         ▄██                                                                        
                                                                                                                                        ▀███▄                     ██  ▀██▄                     ▄██▀                                                                         
                                                                                                                                          ▀███▄                   ██    ▀██▄                 ▄██▀                                                                           
                                                                                                                                            ▀███▄                 ██      ▀██▄             ▄██▀                                                                             
                                                                                                                                              ▀█████████████████████        ▀███████████████▀                                                                               